030605900
098034200
700000050
680090400
007500390
005300008
000926004
349001672
056073080